1111111111111111111111111111111111111111
1100000111111111111111000001111111111111
1100000111111111111111000001111111111111
1160011111111111111111600111111111111111
1000000000000002111111000000000000000001
1000000000000000111111000000000000000001
1000000000000000111111000000000000000001
1000000000000000111111000000000000000001
1111111100000000111111000001100011000001
1111111100000000111111000001000001000001
111111110000000000000000000100+001000001
1111111100000000000000000001000001000001
1111111100000000004000000001111111000001
1111111100020000000000000021111111003001
1000000000000000111111111111111111000001
1000000000000000111111111111000007000001
1000000800000000111111111111000000000001
1000000000000000111111111111005000000001
1000000000000000111111111111000001000001
1111111111111111111111111111111111111111